people 

mother: die Mutter
father: der Vater
sister: die Schwester
brother: der Bruder
child: das Kind
aunt: die Tante 
uncle: der Onkel
grandmother: die Groβmutter 
grandfather: der Groβvater 
female cousin: die Cousine
male cousin: der Cousin 
boyfriend: der Freund 
girlfriend: die Freundin 
husband: der Mann 
wife: die Frau 
male colleague: der Kollege 
female colleague: die Kollegin 
male partner: der Partner 
female partner: die Partnerin

Household Objects

house: das Haus 
bed: das Bett 
table: der Tisch 
door: die Tür 
pillow/cushion: das Kissen 
window: das Fenster 
wall: die Wand 
floor: der Boden 
bedroom: das Schlafzimmer 
bathroom: das Badezimmer 
kitchen: die Küche 
living room: die Wohnung 
basement: der Keller 
couch: die Couch 
chair: der Stuhl 
sink: das Waschbecken 
toilet: die Toilette 
bathtub: die Badewanne 
shower: die Dusche 
lamp: die Lampe 
trash: der Müll 
refrigerator: der Kühlschrank
stove: der Herd 
microwave: der Mikrowellenherd
dishwasher: die Geschirrspülmaschine 
cabinet: das Kabinett

Transportation

car: das Auto 
truck: der Lustkraftwagen (LKW)
bus: der Bus 
plane: das Flugzeug 
train: der Zug 
boat: das Boot 
taxi: das Taxi
school bus: der Schulbus 
ticket: das Ticket 
pass: der Pass 
semi truck: der Sattelzug

Locations

city: die Stadt 
country: das Land 
mountain: der Berg 
plains: die Ebenen 
desert: die Wüste 
school: die Schule 
work: die Arbeit 
homeland: das Heimatland

Occupations

pilot:
der Pilot
die Pilotin 
doctor:
der Doktor
die Doktorin 
dentist:
der Zahnarzt
die Zahnarztin 
librarian:
der Bibliothekar
die Bibliothekarin 
hairdresser:
der Friseur
die Friseurin 
lawyer:
der Rechtsanwalt
die Rechtsanwältin 
salesman/woman:
der Verkäufer
die Verkäuferin 
bus driver:
der Busfahrer
die Busfahrerin 
teacher:
der Lehrer
die Lehrerin 
professor:
der Professor
die Professorin 
assistant:
der Assistent
die Assistentin 
stock broker:
der Börsenmakler
die Börsenmaklerin 
marketer:
der Vermarkter
die Vermarkterin 
insurance agent:
der Versicherungsagent
die Verischerungsagentin 
truck driver:
der LKW-Fahrer
die LKW-Fahrerin 
writer:
der Schriftsteller
die Schriftstellerin 
editor:
der Redakteur
die Redakteurin
journalist:
der Journalist
die Journalistin 
machinist:
der Mechaniker
die Mechanikerin 
carpenter:
der Zimmermann
die Zimmerfrau 
computer programmer:
der Computerprogrammierer
die Computerprogrammiererin 
personal trainer:
der persönliche Trainer
die persönliche Trainerin 
supervisor:
der Vorgesetzte
die Vorgesetzterin 
boss:
der Chef
die Chefin 
caregiver:
der Pfleger
die Pflegerin
clerk:
der Angestellter
die Angestellte 
detective:
der Detektiv
die Detektivin 
police officer:
der Polizeibeamte
die Polizeibeamtin 
firefighter:
der Feuerwehrmann
die Feuerwehrfrau

Food

breakfast: das Frühstuck 
lunch: das Mittagessen 
dinner: das Abendessen 
snack: der Snack 
dessert: das Dessert
cake: der Kuchen 
bread: das Brot 
milk: die Milch 
egg: das Ei 
flour: das Mehl 
sugar: der Zucker 
meat: das Fleisch 
turkey: der Truthahn 
pork: das Schweinefleisch 
chicken: das Huhn 
tofu: der Tofu 
salad: der Salat 
pizza: die Pizza 
cracker: die Cracker 
cereal: das Müsli 
oatmeal: das Haferflocken 
pancakes: die Pfannkuchen 
bacon: der Speck 
chocolate: die Schokolade 
fruit: das Obst 
vegetable: das Gemüse 
apple: der Aprfel 
carrot: die Karotte 
pear: die Birne 
banana: die Banane 
tomato: die Tomate 
potato: die Kartoffel 
celery: der Sellerie 
broccoli: der Brokkoli 
onion: die Zwiebel 
cucumber: die Gurke 
zucchini: die Zucchini 
peach: der Pfirsich 
nut: die Nuss
brussel sprouts: der Rosenkohl 
lasagna: die Lasagna 
spaghetti: die Spaghetti 
macaroni: die Makkaroni 
peanut butter: die Erdnussbutter 
jelly: das Gelee 
sandwich: das Sandwich 
burger: der Burger 
fries: die Pommes 
soup: die Suppe 
fish: der Fisch 
rice: der Reis 
beans: die Bohnen 
burrito: der Burrito 
ham: der Schinken 
pasta: die Pasta

Pets

dog: der Hund 
cat: die Katze 
fish: der Fisch 
bird: der Vogel 
snake: die Schlange 
mouse: die Maus 
gerbil: die Rennmaus 
hamster: der Hamster 
ferret: das Frettchen

Clothing Items

shirt: das Hemd 
pants: die Hose 
coat: der Mantel 
socks: die Socken 
shoes: die Schuhe 
shorts: die Shorts 
underwear: die Unterwäsche 
blouse: die Bluse 
bra: der Büstenhalter (BH, for short!)
jeans: die Jeans 
belt: der Gürtel 
hat: der Hut 
tie: die Krawatte 
dress: das Kleid 
skirt: der Rock 
boots: die Stiefel

Sports

baseball: der Baseball 
basketball: der Basketball 
soccer: der Fuβball 
football: der Football 
hockey: das Hockey 
rugby: das Rugby 
tennis: das Tennis 
lacrosse: das Lacrosse 
cricket: das Cricket 
volleyball: der Volleyball 
golf: der Golf

Personal Belongings

purse: der Geldbeutel 
cellphone: das Handy 
keys: die Schlüssel 
wallet: das Portemonnaie
money: das Geld 
watch: die Uhr 
jewelry: der Schmuck 
chapstick: der Lippenstift
bag: die Tasche 
laptop: der Laptop 
iPod: der iPod 
MP3 player: der MP3-Player 
notebook: das Notebook 
credit card: die Kreditkarte 
driver’s license: der Führerschein

